10 10
XXXXXXXXXX
X+ XX    X
X  X  X  X
XX X XXX X
XX X XX  X
X    X  XX
XXXXXX XXX
X        X
X XXXXXX-X
XXXXXXXXXX
